1111111111111111111111111111111111111111
10100000000000E000000000000C000000000011
1000100010010010100000011110000000111001
10110000100011000000C1C00000001101100001
1010000000000C01000000010000000C00110001
1000C0000001010100000000C000000000000C01
10110000100011000000C1C00000001001100001
1000011100100100000C0000000000C0C0C00001
100000010C100010100001111111100100011101
11000000100110000001100000000101111C0001
10100000000000001C0000000000C00000000001
1110000000011000100111111100000011000001
10110000100011000000C1C00000001100000001
1010C000C0000000C00000000C00000000000001
11100110001000000C0000C00000010100100001
101000101C000100000000000000C00000011111
10110000100011000000C1C00000001100000001
11010100001001C00000000000C00C00C0010001
10101100C0P0C0000000000000C00C0000000C01
100C0001110000011000000000C0000000E00011
10110000100011000000C1C00000001100100001
1111111111111111111111111111111111111111