11111111111111111111111
1C00000000000100C000001
10000000000000000000001
1101110000111100C000001
1E000000000111000001001
1111111100001100P001001
1C000000000001000001101
100000000000C1000000101
11011100001111000000101
100000C0000C000000C01C1
11111111111111111111111