11111111111111
1C000000010001
10000000P00001
11011100001111
1E000000100001
11111111111111